----#####----------
----#   #----------
----#$  #----------
--###  $##---------
--#  $ $ #---------
### # ## #---######
#   # ## #####  ..#
# $  $          ..#
##### ### #@##  ..#
----#     #########
----#######--------