-------#######----
-#######     #----
-#     # $@$ #----
-#$$ #   #########
-# ###......##   #
-#   $......## # #
-# ###......     #
##   #### ### #$##
#  #$   #  $  # #-
#  $ $$$  # $## #-
#   $ $ ###$$ # #-
#####     $   # #-
----### ###   # #-
------#     #   #-
------########  #-
-------------####-