---##########---
---#..  #   #---
---#..      #---
---#..  #  ####-
--#######  #  ##
--#            #
--#  #  ##  #  #
#### ##  #### ##
#  $  ##### #  #
# # $  $  # $  #
# @$  $   #   ##
#### ## #######-
---#    #-------
---######-------