-----###########---
-----#  .  #   #---
-----# #.    @ #---
-##### ##..# ####--
##  # ..###     ###
# $ #...   $ #  $ #
#    .. ##  ## ## #
####$##$# $ #   # #
--## #    #$ $$ # #
--#  $ # #  # $## #
--#               #
--#  ###########  #
--####---------####