############--
#..  #     ###
#..  # $  $  #
#..  #$####  #
#..    @ ##  #
#..  # #  $ ##
###### ##$ $ #
--# $  $ $ $ #
--#    #     #
--############