----##########-----
#####        ####--
#     #   $  #@ #--
# #######$####  ###
# #    ## #  #$ ..#
# # $     #  #  #.#
# # $  #     #$ ..#
# #  ### ##     #.#
# ###  #  #  #$ ..#
# #    #  ####  #.#
# #$   $  $  #$ ..#
#    $ # $ $ #  #.#
#### $###    #$ ..#
---#    $$ ###....#
---#      ##-######
---########--------