--------########-
--------#     @#-
--------# $#$ ##-
--------# $  $#--
--------##$ $ #--
######### $ # ###
#....  ## $  $  #
##...    $  $   #
#....  ##########
########---------