------####---
--#####  #---
-##     $#---
## $  ## ###-
#@$ $ # $  #-
#### ##   $#-
-#....#$ $ #-
-#....#   $#-
-#....  $$ ##
-#... # $   #
-######$ $  #
------#   ###
------#$ ###-
------#  #---
------####---