-----------########
-----------#  ....#
############  ....#
#    #  $ $   ....#
# $$$#$  $ #  ....#
#  $     $ #  ....#
# $$ #$ $ $########
#  $ #     #-------
## #########-------
#    #    ##-------
#     $   ##-------
#  $$#$$  @#-------
#    #    ##-------
###########--------