---------####-----
-#########  ##----
##  $      $ #####
#   ## ##   ##...#
# #$$ $ $$#$##...#
# #   @   #   ...#
#  $# ###$$   ...#
# $  $$  $ ##....#
###$       #######
--#  #######------
--####------------