--------#####----
--------#   #####
--------# #$##  #
--------#     $ #
######### ###   #
#....  ## $  $###
#....    $ $$ ##-
#....  ##$  $ @#-
#########  $  ##-
--------# $ $  #-
--------### ## #-
----------#    #-
----------######-