######--###-
#..  #-##@##
#..  ###   #
#..     $$ #
#..  # # $ #
#..### # $ #
#### $ #$  #
---#  $# $ #
---# $  $  #
---#  ##   #
---#########