-------#####-
-#######   ##
## # @## $$ #
#    $      #
#  $  ###   #
### #####$###
# $  ### ..#-
# $ $ $ ...#-
#    ###...#-
# $$ #-#...#-
#  ###-#####-
####---------