--####----------
--#  ###########
--#    $   $ $ #
--# $# $ #  $  #
--#  $ $  #    #
### $# #  #### #
#@#$ $ $  ##   #
#    $ #$#   # #
#   $    $ $ $ #
#####  #########
--#      #------
--#      #------
--#......#------
--#......#------
--#......#------
--########------