----------#######
----------#  ...#
------#####  ...#
------#      . .#
------#  ##  ...#
------## ##  ...#
-----### ########
-----# $$$ ##----
-#####  $ $ #####
##   #$ $   #   #
#@ $  $    $  $ #
###### $$ $ #####
-----#      #----
-----########----